#######################
# #   #   #     #   # #
# # ### # # ##### # # #
# # # # #     #   #   #
# # # # # ### # # #####
#   #   #         #   #
# # # # # # ##### # # #
# # # # #     #   #   #
#   # # # ### # # #####
# ### # # # ##### # # #
# # # # #     #   #   #
# # # # # ### # # #####
#   # # # # ##### # # #
# # # # #     #   # E #
# # # # # # ##### # # #
# #   ###     #       #
# # # # # ### # # #####
#S# # # # ### # # #####
#######################