#########
#S#   #E#  
# # # # # 
#   # # # 
#########
