#######################
#S#   #   #     #   # #
# # # # # # ##### # # #
# # # # #         #   #
# # # # # ### # # #####
#   #   #     # #    E#
#######################
