##########
#S       #   
#   #    #  
#   #E   #  
##########
